1
10
@@@@@@@@.@
@...@....@
@...@@@..@
@.@@@...@@
@..@@....@
@...@.@@@@
@..@.....@
@..@....@@
@@......@@
@@@@@@x@@@
